10 10
***.******
*........*
***.****.*
***..***.*
********.*
*****....*
*****.****
*****.****
*........*
********.*